De spelling van Jeshu is terug te vinden in Talmud-literatuur.

Abraham: Avráhám, vader van vele volkeren
Izak: Jitsàq, hij lacht
Jakob: Ja’aqov, hij houdt de hiel vast
Juda: Jêhoedáh, JAHWEH zal geprezen worden

Perez: Perets, breuk
Zerah: Zeràch, lichtglans
Hezron: Chètsron, omsloten
Aram: Rám, verheven

Aminadab: Amminádáv, mijn verwant is vrijgevig
Nahesson: Náchson, slang

Rachab: Rácháv, breed uitgestrekt
Obed: Oveed, dienaar
Ruth: Roeth, metgezellin(?)
Isaï: Isàj, Hij is mijn JAHWEH

David: Dávied, beminde
Salomo: Shêlomoh, rijk aan vrede
Uria: Oeri-Jah, Licht is mijn JAHWEH

Rehabeam: Rêchav’ám, uitgebreid is het volk
Abia: Avi-JAH, vader is JAHWEH
Asa: Asá, genezen

Josafat: Jêhoshaphat, JAHWEH richt
Joram: Jorám of Jêhorám, JAHWEH is verheven
DuTillet wordt יוֹרָם als יְהוֹרָם geschreven 
Uzzia: Ozi-JAH, sterkte is JAHWEH
In 1 Kron. 3:12 wordt Uzzia Ahazia genoemd

Jotham: Jotám, JAHWEH is volmaakt
Achaz: Acház, Hij houdt vast
Hizkia: Chizqi-JAH, sterkte is JAHWEH

Manasse: Mênàshèh, doende vergeten
Amon, betrouwbaar
Josia: Josi-JAH, JAHWEH schraagt

Jechonia: Jêchán-JAH, JAHWEH bevestigt

Sealthiël: Shê’àlti’èl, ik heb God gevraagd
Zerubbabel: ZêruvBávèl, zaad van Babel

Abihud: Avihoed, vader is majesteit
Abner: vader is lamp 
In Griekse en Aramese handschriften ontbreekt de naam Abner
Eljakim of Elkim, God zal bevestigen 
DuTillet wordt אֶקִים als אֶלְיָקִים geschreven 

Azor: Azzoer, geholpen
Zadok: Tsádoq, rechtvaardig
Amnon, betrouwbaar
Eliud: Elihoed, God is majesteit

Eleazar: Elázár, God heeft geholpen
Matthan: Màttán, gave (van God) 

Jozef: Joséph, Jahweh voege bij
Mirjam, weerspannige (?)
Jeshua: Jéshoe’à, JAHWEH is verlossing
Messias: Máshiàch, gezalfd
Vreemde taal: Grieks

Drie koningen van Juda ontbreken, zie 1 Kron. 3:11-12, maar er zijn drie vrouwen bij name genoemd

Samengekomen, letterlijk: seksueel bekennen of gemeenschap hebben
DuTillet wordt ‘zij bedekt werd met’ geschreven als נִמְצָאָה הָרָה wat vertaald kan worden als ‘zij zwanger werd bevonden door’

Verlaten, letterlijk: deportatie
Verbintenis, daarmee wordt de ondertrouw bedoeld, het huwelijk is al wettelijk

Beraamde, letterlijk: denkend beramen
Letterlijk ‘dat is van’ is ‘dat zij is bedekt’, zie ook vers 18

Er is woordverband tussen de naam ‘Jeshua’ (Jéshoe’à), dat is ‘JAHWEH is verlossing’, en het woord ‘verlossen’: יֵשׁוּעַ (Jê’oshi’à)
In Griekse en het DuTillet-handschrift staat ‘Zijn volk’ in plaats van ‘Mijn volk’, het verschil tussen een waav (ו) en jod (י)
In Griekse en Aramese handschriften ontbreekt het woord ‘alle’ (מְכֹּל)

In Griekse en Aramese handschriften ontbreekt het woord ‘mond’ (פִּי) en de Naam van God
Jesaja: Jêshà’-JAH, JAHWEH is (mijn) heil, de naam die ontbreekt in Griekse en Aramese handschriften

Citaat uit Jesaja 7:14
In Griekse en Aramese wordt voor ‘huwbare vrouw’ ‘maagd’ gebruikt, in het Hebreeuws is dat een ander woord: בְּתוּלָה (bêtoeláh)
Er is woordverband tussen ‘mijn volk’: עַמִּי (àmi) en de naam ‘Immanuël’: עִמָּנוּאֵל (Immànie’èl).
Godheid, de Hebreeuwse meervoudsvorm van God. De schrijfwijze hier אֱלֹקִים wijkt af van het gebruikelijke אֱלֹהִים.



